----------------
----------------
----------------
----------------
----------------
----------------
----------------
----------------
----------------
----------------
-----------o----
--------o-XX----
------o-XXXX----
------XXXXXX----
XXXXXXXXXXXXXXXX