----------------
----------------
----------------
----------------
----------------
----------------
----------------
----------------
-------oo-------
----------------
-------XX-------
----o-XXXX-o----
-----XXXXXX-----
---XXXXXXXXXX---
XXXXXXXXXXXXXXXX