----------------------
----------------------
----------------------
----------------------
----------------------
----------------------
----------------------
----------------------
----------------------
----------------------
-------XXXXXXXX-------
----------------------
-------V--o---V-----o-
----------------------
XXXXXXXXXXXXXXXXXXXXXX