----------------------
----------------------
----------------------
----------------------
-----------o----------
----------------------
---------XXXXX--------
-----------o----------
----------------------
-------X-H-----X------
---XX--XXXXXXXXX--XX--
----------------------
-------V---o---V----o-
----------------------
XXXXXXXXXXXXXXXXXXXXXX