----------------------
----------------------
----------------------
----------------------
----------------------
----------------------
----------------------
----------------------
----------------------
----------------XXX---
-----------------V----
-------X---XX-----V---
------XX------o-V---o-
-----XXX--------------
XXXXXXXX---XXXXXXXXXXX