----------XXXXXXXXXX----------
----------XXXXXXXXXX----------
----------XXXXXXXXXX----------
----------XXXXXXXXXX----------
----------XXXXXXXXXX----------
----------XXXXXXXXXX----------
----------XXXXXXXXXX----------
----------XXXXXXXXXX--o-------
-o--------XXXXXXXXXX----------
----------XXXXXXXXXX--X-------
----------XXXXXXXXXX----------
XXX-------XXXXXXXXXXX---------
------XX-----oooo-----------o-
------------------------------
XXXX--------XXXXXX---XX---XXXX