----------------------
----------------------
----------------------
----------------------
----------------------
----------------------
----------------------
----------------------
----------------------
----------------------
----------------------
----------------------
--------------X-------
-----o-----o--X------o
XXXXXXXXXXXXXXXXXXXXXX