----------------------
----------------------
----------------------
-----------------X----
----------------------
----------------------
----------------------
----------------------
----------------------
----------------------
----------------------
----------------------
--------------X-------
-----o-----o--X------o
XXXXXXXXXXXXXXXXX^XXXX