----------------------
----------------------
----------------------
----------------------
----------------------
----------------------
----------------------
----------------------
----------------------
----------------------
----------------------
-----------o----------
--------------------o-
-----X---H-----X------
XXXXXXXXXXXXXXXXXXXXXX