----------------
----------------
----------------
----------------
----------------
----------------
----------------
----------------
----------------
----------------
-------XX-------
------XXXX------
----XXXXXXXX----
--XXXXXXXXXXXX--
XXXXXXXXXXXXXXXX