----------------------
----------------------
----------------------
----------------------
----------o-----------
----------------------
--------XXXXX---------
----------o-----------
----------------------
-------X-H----X-------
-------XXXXXXXX--XX---
----------------------
-------V--o---V-----o-
----------------------
XXXXXXXXXXXXXXXXXXXXXX