----------------------
----------------------
----------------------
----------------------
----------------------
----------------------
----------------------
----------------------
----------------------
----------------------
----------------------
-------XXXXXXXX-------
----------------------
-------V--o---V-------
----------------------
XXXXXXXXXXXXXXXXXXXXXX