----------------
----------------
----------------
----------------
----------------
----------------
----------------
----------------
----------------
----------------
---------XX-----
-------XXXX-----
-----XXXXXX-----
---XXXXXXXX-----
XXXXXXXXXXXXXXXX