----------------------
----------------------
----------------------
----------------------
----------o-----------
----------------------
--------XXXXX---------
--------V---V---------
----------o-----------
----------------------
------XXXXXXXXX-------
-----------o----------
--------------------o-
-----X---H-----X------
XXXXXXXXXXXXXXXXXXXXXX