------------------
------------------
------------------
------------------
------------------
------------------
------------------
------------------
------------------
------------------
------------------
------------------
----XX------XX----
--XXXXXX--XXXXXX--
XXXXXXXXXXXXXXXXXX