----------------------
----------------------
----------------------
----------------------
----------------------
----------------------
----------------------
----------------------
----------------------
----------------------
-----------------X----
-----------------V----
-------X--------------
------XX------o----o--
-----XXX--------------
XXXXXXXX---XXXXXXXXXXX