--------------------XX
--------------------XX
--------------------XX
--------------------XX
--------------------XX
-----------X-H---o--XX
-----------------o--XX
---------o----------XX
-----------XXXXXXX--XX
--------------------XX
-------X------------XX
------XXX-----------XX
-----XXXXX-----------o
----XXXXXXX-----------
XXXXXXXXXXXXXXXX--XXXX