--------------------XX
--------------------XX
--------------------XX
--------------------XX
--------------------XX
--------------------XX
-------------H------XX
-----------------o--XX
--------------------XX
-----------XXXXXXX--XX
--------------------XX
-------X------------XX
------XXX-----------XX
-----XXXXX-----------o
----XXXXXXX-----------
XXXXXXXXXXXXXXXX--XXXX