---------------------X--------
---------------------X--------
-------------------o-X--------
---------------------X--------
---------------------X--------
------------------XXXX--------
------------------------------
-----------o--XX--------------
------------------------------
----------XX----------------o-
------------------------------
--------------XX---XXX----XXXX
------------------------------
----------XX------------------
------------------------------
XXXXXXXX----------------------