--------XXXXXXXXXXXXXX--------
-------------------ooX--------
---------------------X--------
---------------------X--------
------------------XXXX--------
------------------X-----------
-----------o--XXXXX-----------
------------------------------
---------XX-----------------o-
------------------------------
--------------XX---XXX----XXXX
------------------------------
----------XX------------------
------------------------------
XXXXXXXX----------------------