------------------------------
-o----------------------------
------------------------------
XXX---------------------------
------------------------------
-----XXX----------------------
------------------------------
-----------XXX-----------------
-0--------------------------o-
------XXX---------------------
XXX-----------------------XXXX
------------XXX-------XX------
------------------XX----------
------------------------------
XXXXXXXX---XXXXX--------------