0-----------------------------
------------------------------
X---XX------------------------
------------------------------
--------XX--------------------
XX----------------------------
--------XXXXX-----------------
--------Xoo-------------------
XXX-----Xoo----o------------o-
--------X---------------------
--------XXX---XX----XX----XXXX
XXXX--------------------------
------------------------------
------------------------------
XXXXXXXX----------------------
