-------------------V---------------
-----------------o---o-------------
------------X-H------------H--XXX--
-----V------XXXXXXXXXXXXXXXXXXXXX--
--------XX----o--------------------
-----------------------------------
-----------XXXXXX---Ho-------------
-----------------------------------
-------------V------XX--------H----
-----------------------------------
XX--------o------XXXXX----H--------
-----------------------------------
---X----H----H-X-----------------o-
---XXXXXXXXXXXXX-------------------
XXXX--------------------------XXXXX