-----------------o--V-----o--------
-----------------H--------H--------
------------XXXXXXXXXXXXXXXXXXX----
-----V--------------H--------------
--------XX----o--------------------
-----------------------------------
-----------XXXXXX---Ho-------------
-----------------------------------
-------------V------XX--------H----
-----------------------------------
XX--------o------XXXXX----H--------
-----------------------------------
---X----H----H-X-----------------o-
---XXXXXXXXXXXXX-------------------
------------------------------XXXXX
