----------XXXXXXXXXX----------
----------XXXXXXXXXX----------
----------XXXXXXXXXX----------
----------XXXXXXXXXX----------
----------XXXXXXXXXX----------
----------XXXXXXXXXX----------
----------XXXXXXXXXX----------
-------oo---XXXXXXXX----------
-o----------XXXXXXXX----------
------XXXX--XXXXXXXX----------
--------------o---------------
XXXX--------------------------
-------------XXXX-----------o-
---------------------XX-------
XXXXXXXX-----------------XXXXX