-----------XXX-------XXX---------------
------------V---------V-------V--------
---------------------------------------
-----------------------------b---------
--------C---o----C--o------------------
---------XXXXXXXXXXXXX--C-------XXV--V-
---------------------------------------
--------------------b------------------
--------------------------------XXXX---
------------XXXX-------XXX-------------
X-------H-------H-------H---------H---X
XXXX----XXX-----------------XXXX-XXXXXX
---------------------------------------
---------------------------------------
XXXXXXX------------------X^--XXX^X--XXX
&
-XXX----------V----XXX-----------------
--V-----------------V------------------
---------o---o-------------------------
---------X---XX------------------------
----------------------------C----------
------------------XX--------------V----
-----------V---------------------V-----
----------------------XXX--------------
---------------------------------------
----------------------------CXXX-------
---------------------------------------
-----------X-----H-----X-X-------------
-----b-----X-----H-----X-X-------------
-----------X-----H-----X^X-------------
XXX------XXXXXXXXXXXXXXXXX----------XXX