-----------XXX-------XXX---------------
------------T---------T----------------
-----------V-V-------------------------
---------------------------------------
---------------------V-V---------------
---------------------------------------
-----------C-----------------------C---
-------X-------H--------H-X------------
-----XXXXXXXXXXXXXXXXXXXXXX------------
---------------------------------------
---b------------o------------XX--------
---------------------------------------
----------------X---X----XX------------
---------------------------------------
XXX---------------------------------XXX
&
-------XXX-----XXX---------------------
--------T-------T-----------o----------
---------------------------------------
----------------------------X----------
----------------------------V----------
--bXX-------------------X--------------
--bXX-------------------V--------------
--bXX----------------X-----------------
--bXX----------------V-----------------
--bXX-------C-----------XXX------------
--bXX----------------------------------
--bXX------------------------XXX-------
--bXX----------------------------------
---XX-----------H----H------H------X---
XXXXX---XXXXXXXXXXXXXXXXXXXXXXXXXXXXXXX
&
-------XXX----V---V--V-----------------
--------T------------------------------
---------------------------------------
---------------------------------------
-------------------o-------------------
--bXX----------------------------------
--bXX--------------X-------------------
--bXX----------------------------------
--bXX-----C----X-----------------------
--bXX----------------------------------
--bXX-------------X--------------------
--bXX-----------------X-------H----X---
--bXX---------XX------X----H-------X---
---XX-----------------X-H----------X---
XXXXX---XXXX----------XXXXXXXXXXXXXXXXX