-----------XXX-------XXX----C----------
--------C---V----X----V-------V--------
---------------------------------------
---------------------------------------
------------o-------o------------------
---------XXXXXXXXXXXXXXXXXXXXXXXXXV--V-
---------------------------------------
---------------------------------------
--------------------------------XXXX---
--------------b--b--b--b--b------------
---------------------------------------
XXXX----XXX------------------XXX-XXXXXX
---------------------------------------
------X-H-H-H-H-H-H-H-H-H-HX-----------
XXXXXXX------------------XXX-XXX^X--XXX
&
-XXX----------V----XXX-----------------
--V-----------------V------------------
---------o---o-------------------------
---------X---XXX-----------------------
----------------------------C----------
------------------X---------------V----
-----------V---------------------V-----
----------------------XXX--------------
---------------------------------------
----------------------------CXXX-------
---------------------------------------
-----------X-----H-----X-X-------------
-----b-----X-----H-----X-X-------------
-----------X-----H-----X^X-------------
XXX------XXXXXXXXXXXXXXXXX----------XXX