-----------XXX-------XXX---------------
------------T---------T----------------
---------------------------------------
-----------------------------b---------
--------C---o----C--o------------------
---------XXXXXXXXXXXXX--C-------XX-----
------------T--------------------------
--------------------b------------------
--------------------------------XXXX---
------------XXXX-------XXX-------------
X-------H-------H-------H---------H---X
XXXX----XXX-----------------XXXX-XXXXXX
---------------------------------------
---------------------------------------
XXXXXXX------------------X^--XXX^X--XXX
&
-XXX---------------XXX-----------------
--T-----------------T------------------
---------o---o-------------------------
---------X---XX------------------------
----------------------------C----------
------------------XX-------------------
---------------------------------------
----------------------XXX--------------
---------------------------------------
----------------------------CXXX-------
---------------------------------------
-----------X-----H-----X-X-------------
-----b-----X-----H-----X-X-------------
-----------X-----H-----X^X-------------
XXX------XXXXXXXXXXXXXXXXX----------XXX