-----------XXX-------XXX---------------
------------T---------T----------------
-----------V-V-------------------------
---------------------------------------
---------------------V-V---------------
---------------------------------------
-----------C-----------------------C---
---------------------------------------
-----XX^XXXXXXXXXXXXXXXXX^X------------
---------------------------------------
---b------------o------------XX--------
---------------------------------------
----------------X---X----XX------------
---------------------------------------
XXX---------------------------------XXX
&
-------XXX-----XXX---------------------
--------T-------T-----------o----------
---------------------------------------
----------------------------X----------
----------------------------V----------
--bXX-------------------X--------------
--bXX-------------------V--------------
--bXX----------------X-----------------
--bXX----------------V-----------------
--bXX-------------------XXX------------
--bXX----------------------------------
--bXX------------C---C--C----XXX-------
--bXX----------------------------------
---XX----------------------------------
XXXXX---^XXXXXXXXXX^XXXXXXXXXXXXX^XXXXX
&
-------XXX----V---V--V-----------------
--------T------------------------------
---------------------------------------
---------------------------------------
-------------------o-------------------
--bXX----------------------------------
--bXX--------------X-------------------
--bXX----------------------------------
--bXX----------X-----------------------
--bXX----------------------------------
--bXX-------------X--------------------
--bXX----------------------C--C--------
--bXX---------XX-----------------------
---XX----------------------------------
XXXXX---^XXX----------^XXXXXXXXXX^XXXXX