-----------XXX-------XXX---------------
------------T---------T----------------
-----------V-V-------------------------
---------------------------------------
---------------------V-V---------------
---------------------------------------
---------------------------------------
------X-------H------H----X------------
-----XX^XXXXXXXXXXXXXXXXX^X------------
---------------------------------------
---b------------o------------XX--------
---------------------------------------
----------------X---X----XX------------
---------------------------------------
XXX---------------------------------XXX
&
-------XXX-----XXX---------------------
--------T-------T-----------o----------
---------------------------------------
----------------------------X----------
----------------------------V----------
--bXX-------------------X--------------
--bXX-------------------V--------------
--bXX----------------X-----------------
--bXX----------------V-----------------
--bXX-------------------XXX------------
--bXX----------------------------------
--bXX------------------------XXX-------
--bXX----------------------------------
---XX---------H-------H----H-------X---
XXXXX---^XXXXXXXXXX^XXXXXXXXXXXXX^XXXXX
&
-------XXX-----XXX---------------------
--------T-------T-----------o----------
---------------------------------------
----------------------------X----------
----------------------------V----------
--bXX--------H----------X--------------
--bXX-------------------V--------------
--bXX--------H-------X-----------------
--bXX----------------V-----------------
--bXX-----------H-------XXX------------
--bXX----------------------------------
--bXX-------------------H----XXX-------
--bXX----------------------------------
---XX--------H-----------H---------X---
XXXXX---^XXXXXXXXXX^XXXXXXXXXXXXX^XXXXX
&
-------XXX----V---V--V-----------------
--------T------------------------------
---------------------------------------
---------------------------------------
-------------------o-------------------
--bXX----------------------------------
--bXX-----H--------X-------------------
--bXX----------------------------------
--bXX-----H----X-----------------------
--bXX----------------------------------
--bXX-----H-------X--------------------
--bXX----------------------------------
--bXX-----H---XX-----------------------
---XX----------------------------------
XXXXX---^XXX----------^XXXXXXXXXX^XXXXX