--------------
--------------
--------------
--------------
--------------
--------------
--------------
--------------
--------------
--------------
--------------
------C-------
--------------
--------------
XXXXXXXXXXXXXX