--------------
--------------
--------------
--------------
--------------
--------------
--------------
--------------
--------------
--------------
-------C------
--------------
----XXXXXX----
--XXXXXXXXXX--
XXXXXXXXXXXXXX