--------------
--------------
--------------
--------------
--------------
--------------
--------------
--------------
--------------
--------------
--------------
------C-------
--------------
--------------
XXXXXXXXXXXXXX
&
--------------
--------------
--------------
--------------
--------------
--------------
--------------
--------------
--------------
--------------
--------------
-------C------
----XXXXXX----
--XXXXXXXXXX--
XXXXXXXXXXXXXX