-----------XXX-------XXX---------------
--------C---T----C----T-------C--------
---------------------------------------
---------------------------------------
------------o-------o------------------
XXX------XXXXXXXXXXXXX---XXXXXXXXX-----
-T-------------------------------------
---------------V-----V-----------------
--------------------------------XXXX---
---------------------------------------
X-------H-------------------------H---X
XXXX----XXX---XXXX---XXXX---XXXX-XXXXXX
---------------------------------------
---------------------------------------
XXXXXXX------------------X^--XXX^X--XXX
&
-XXX--------------------------XXX------
--T----------------------------T-------
---------o---o-------------------------
---------X---XX------------------------
----------------------------C----------
------------------XX-------------------
---------------------------------------
----------------------XXX--------------
---------------------------------------
----------------------------CXXX-------
---------------------------------------
-----------X-----H-----X-X-------------
-----------X-----H-----X-X-------------
-----------X-----H-----X^X-------------
XXXXXX---XXXXXXXXXXXXXXXXX----------XXX