-----------XXX-------XXX---------------
------------T---------T----------------
------------------------------C--------
---------------------------------------
--------C---o----C--o------------------
---------XXXXXXXXXXXXX---XXXXXXXXX-----
------------T--------------------------
---------------------------------------
--------------------------------XXXX---
------------XXXX----XXXXXX-------------
X-------H-------H-------H---------H---X
XXXX----XXX-----------------XXXX-XXXXXX
---------------------------------------
---------------------------------------
XXXXXXX------------------X^--XXX^X--XXX
&
-XXX---------------XXX-----------------
--T-----------------T------------------
---------o---o-------------------------
---------X---XX------------------------
----------------------------C----------
------------------XX-------------------
---------------------------------------
----------------------XXX--------------
---------------------------------------
----------------------------CXXX-------
---------------------------------------
-----------X-----H-----X-X-------------
-----------X-----H-----X-X-------------
-----------X-----H-----X^X-------------
XXXXXX---XXXXXXXXXXXXXXXXX----------XXX