--------------
--------------
--------------
--------------
--------------
--------------
--------------
--------------
--------------
--------------
--------------
------C-------
--------------
--------------
XXX^XXXXXXX^XX
&
--------------
--------------
--------------
--------------
--------------
--------------
--------------
--------------
--------------
--------------
------C-------
--------------
--------------
---XXXXXXXX---
XX^XXXXXXXX^XX