---------------
---------------
---------------
---------------
---------------
---------------
---------------
---------------
---------------
---------------
---V-------V---
-------C-------
---------------
---X---H---X---
XX^XXXXXXXXX^XX
&
---------------
---------------
---------------
---------------
---------------
---------------
---------------
---------------
---------------
---V-------V---
-------C-------
---------------
---------------
---X---H---X---
XX^XXXXXXXXX^XX