--------------
--------------
--------------
--------------
--------------
--------------
--------------
--------------
--------------
--------------
--------------
---V--C--V----
--------------
--------------
XXXXXXXXXXXXXX
&
--------------
--------------
--------------
--------------
--------------
--------------
--------------
--------------
--------------
---V------V---
------C-------
--------------
--------------
---XXXXXXXX---
XXXXXXXXXXXXXX