--------------
--------------
--------------
--------------
--------------
--------------
--------------
--------------
--------------
--------------
---X-----X----
---V--C--V----
--------------
--------------
XXXXXXXXXXXXXX
&
--------------
--------------
--------------
--------------
--------------
--------------
--------------
--------------
---X------X---
---V------V---
------C-------
--------------
--------------
---XXXXXXXX---
XXXXXXXXXXXXXX