----------------------------------------XXXXXXXXXXXXXX------
--------------------------V-------------X-T----T----T-------
--o-----C----------C----o---------------X-----------------o-
----------------------------------------X-------------------
--X---------------------X-------------o-X-----------------X-
-------------------------------b---b----X-------------------
----------------------------------------X---------------X---
XXXXXXXXXXXXXXXXXXXXXXXXXXXXH---------X-X---------------X---
----------------------------------------X------------X--X---
-------------V------------------------------------------X---
---------------V--------------------X-------------X-----X---
----X----H-------------X--------------------------------X---
---XX------------------XX---H----X-----H-------X--------X---
--XXX--------------H---XXX------------------------------X---
XXXXXXXX^XXXXXXXX^XXXXXXXXXXXXX-------XXX^XXX-----------X---