----------------------------------------XXXXXXXXXXXXXX------
--------------------------V-------------X-T----T----T-------
--o---------------------o---------------X-----------------o-
--------C-----C----C--------------------X-------------------
--X---------------------X-------------o-X-----------------X-
-------------------------------b---b----X-------------------
----------------------------------------X---------------X---
XXXXXXXXXXXXXXXXXXXXXXXXXXXXH---------X-X---------------X---
-------V----------T---------------------X------------X--X---
-----------V--------------------------------------------X---
---------------V--------------------X-------------X-----X---
----X----H-------------X--------------------------------X---
---XX---------H--------XX---H----X-------------X--------X---
--XXX--------------H---XXX------H-----H-X-X-------------X---
XXXXXXXX^XXXXXXXXXXXXXXXXXXXXXX---------X^XXX---------^^X---