--------------
--------------
--------------
--------------
--------------
--------------
--------------
--------------
--------------
--------------
--------------
--------------
--------------
---X--H-----X-
XXXXXXXXXXXXXX