-------XXXXXX--------
-------XXXXXX--------
-------XXXXXX--------
-------XXXXXX--------
-------XXXXXX--------
-------XXXXXX--------
-------XXXXXX--------
-------XXXXXX--------
-------XXXXXX--------
-------V----V--------
---------oo----------
-------XXXXXX--------
-------o----o--------
-----X----H---X------
XXXXXXXXXXXXXXXXXXXXX