---------------------
---------------------
---------------------
---------------------
---------------------
---------------------
---------------------
---------------------
------o------o-------
---------------------
------X---H--X-------
XXX---XXXXXXXX-------
-------oV--Vo--------
----X----------X-----
XXXXXXXXXXXXXXXXXXXXX