------------------
------------------
------------------
------------------
------------------
------------------
------------------
------------------
------------------
------------------
------------------
--------oo--------
----XX------XX----
--XXXXXX--XXXXXX--
XXXXXXXXXXXXXXXXXX