----------------
----------------
----------------
----------------
----------------
----------------
----------------
----------------
----------o-----
----------------
---------XX-----
-------XXXXX----
-----XXXXXXXX---
---XXXXXXXXXXX--
XXXXXXXXXXXXXXXX