---------------------
---------------------
---------------------
---------------------
---------------------
---------------------
---------------------
---------------------
---------------------
---------------------
---------oo----------
-------^XXXX^--------
-------o----o--------
-----X----H---X------
XXXXXXXXXXXXXXXXXXXXX