----------------------
----------------------
----------------------
----------------------
----------------------
----------------------
----------------------
----------------------
----------o-----------
-------X---H-X--------
-------X--H--X--------
-----XXXXXXXXXXX------
---------ooo----------
----------------------
XXXXXXXX^XXX^XXXXXXXXX