----------------------
----------------------
----------------------
----------------------
----------------------
----------------------
----------------------
----------------------
----------------------
----------------------
------------------o---
---X-X----------------
---X^X-----H------X---
--XXXX--H-----H---X---
XXXXXXXXXXXXXXXXXXXXXX