---------------------
---------------------
---------------------
---------------------
---------------------
---------------------
---------------------
---------------------
---------------------
---------------------
--------------XXXXX--
--------------V---V--
----------------o----
-----X-H---HX--------
XXXX^XXXXXXXXXXXXXXXX