------------------XXX
------------------XXX
------------------XXX
-------------o----XXX
------------------XXX
-----------XXXX---XXX
------------------XXX
------------------XXX
----XXXXXX--------XXX
------------------XXX
XXX------o--------XXX
---------------------
-----XXXXXXXX--------
---------------------
XXX-----------XXXXXXX