---------------------
---------o-----------
---------------------
XX----XXXXXXX--------
---------------------
--------------XX-----
XXX------------------
---------------------
o--XXX---------------
---------------------
X--------------------
---------------------
XX-------------------
---------------------
XXX-------------XXXXX