---------------------
----V-V--o-V-----V---
---------------------
XX----XXXXXXX-----V--
---------------------
--------------XX-----
XXX------------------
---------------------
o--XXX-----------V---
---------------------
X-V------------------
---------------------
XX-------------------
---------------------
XXX-------------XXXXX