------------------XXX
------------------XXX
------------------XXX
-------------o----XXX
------------------XXX
-----------XXXX---XXX
------------------XXX
------------V-----XXX
----XXXXXX--------XXX
-----V------------XXX
XXX------o--------XXX
---------------V-----
-----XXXXXXXX--------
---------------------
XXX-----------XXXXXXX