----------XXXXX---------------X
----------V---V---------------X
------------o-----------------X
------------------------------X
----------XXXXX--------------oX
-----------------X-------H----X
-------XX--------X--H------H--X
-----------------XXXXXXXXXXXXXX
----------XX-------------------
-------------------------------
-------X-----------------------
X---H---H--X------------ooo----
----XXX---XXXXXXXXXXXXXXXXX----
-------------------------------
XXX-------------------------XXX