-------------------------------
-------------------------------
-------------------------------
-------------------------------
-------------------------------
-------------------o-----------
-------------------------------
-------------------X-----------
-------------XX----------------
-------------------V-----------
----------X--------------------
---------XV--------------------
--------o---------o------------
--X-H---------------------H---X
XXX----XXXX----XXXXX---X-X--XXX
&
-------------------------------
----------V---V----------------
------------o------------------
-------------------------------
-----------XXXX----------------
-------------------------------
-------XX----------------------
-------------------------------
----------XX-------------------
-------------------------------
-------X-----------------------
X--------------H---------H----X
----XXX---XX--XXX--XX---XXX----
-------------------------------
XXX-------------------------XXX
&
------------------------------X
----------V---V---------------X
------------o-----------------X
------------------------------X
-----------XXXX--------------oX
-----------------X-------H----X
-------XX--------X--H------H--X
-----------------XXXXXXXXXXXXXX
----------XX-------------------
-------------------------------
-------X-----------------------
X---H---H--X------------ooo----
----XXX---XXXXXXXXXXXXXXXXX----
-------------------------------
XXX-------------------------XXX