----------XXXXX----------------
----------V---V----------------
------------o------------------
-------------------------------
----------XXXXX----------------
-------------------------------
-------XX----------------------
-------------------------------
----------XX-------------------
--------------------o----------
-------X-----------------------
X---H----------H---------H----X
----XXX---XX--XXX--XX---XXX----
-------------------------------
XXX-------------------------XXX