-------------------------------
-------------------------------
-------------------------------
-------------------------------
-------------------------------
-------------------o-----------
-------------------------------
-------------------X-----------
-------------XX----------------
-------------------V-----------
----------X--------------------
----------V--------------------
--------o---------oV-----------
--X-H----------H----------H---X
XXX----XXXX----XXXXX---X-X--XXX