---------------------
---------------------
-o-------------------
---------------------
XXX------------------
---------------------
---------------------
XXXXXX---------------
---------------------
-------XXXX----------
---------------------
-------------XXXX----
---------------------
-------XXXXX---------
XXXX------------XXXXX