XXXXXXXXXXXXXXXXXXXXX
XXXXXXXXXXXXXXXXXXXXX
XXXXXXXXXXXXXXXXXXXXX
XXXXXXXXXXXXXXXXXXXXX
XXXXXXXXXXXXXXXXXXXXX
----------------T----
---------------------
---------------------
---------------------
---------------------
---------------------
---------------------
---------------------
---------------------
XXXXXXXXXXXXXXXXXXXXX
&
XXXXXXXXXXXXXXXXXXXXX
XXXXXXXXXXXXXXXXXXXXX
XXXXXXXXXXXXXXXXXXXXX
XXXXXXXXXXXXXXXXXXXXX
XXXXXXXXXXXXXXXXXXXXX
---------T-----------
---------------------
---------------------
---------------------
---------------------
---------------------
---------------------
---------------------
---------------------
XXXXXXXXXXXXXXXXXXXXX
&
XXXXXXXXXXXXXXXXXXXXX
XXXXXXXXXXXXXXXXXXXXX
XXXXXXXXXXXXXXXXXXXXX
XXXXXXXXXXXXXXXXXXXXX
XXXXXXXXXXXXXXXXXXXXX
-----T---------------
---------------------
---------------------
---------------------
---------------------
---------------------
---------------------
---------------------
---------------------
XXXXXXXXXXXXXXXXXXXXX
&
-------------XXX-----
--------------T------
---------------------
---------------------
---------------------
---------------------
---------------------
---------------------
---------------------
---------------------
---------------------
---------------------
---------------------
---------------------
XXXXXXXXXXXXXXXXXXXXX
&
----XXX--------------
-----T---------------
---------------------
---------------------
---------------------
---------------------
---------------------
---------------------
---------------------
---------------------
---------------------
---------------------
---------------------
---------------------
XXXXXXXXXXXXXXXXXXXXX