---------------XXX---
----------------T----
---------------------
---------------------
---------------------
---------------------
---------------------
---------------------
---------------------
---------------------
---------------------
---------------------
---------------------
---------------------
XXXXXXXXXXXXXXXXXXXXX
&
--------XXX----------
---------T-----------
---------------------
---------------------
---------------------
---------------------
---------------------
---------------------
---------------------
---------------------
---------------------
---------------------
---------------------
---------------------
XXXXXXXXXXXXXXXXXXXXX
&
----XXX--------------
-----T---------------
---------------------
---------------------
---------------------
---------------------
---------------------
---------------------
---------------------
---------------------
---------------------
---------------------
---------------------
---------------------
XXXXXXXXXXXXXXXXXXXXX
&
-------------XXX-----
--------------T------
---------------------
---------------------
---------------------
---------------------
---------------------
---------------------
---------------------
---------------------
---------------------
---------------------
---------------------
---------------------
XXXXXXXXXXXXXXXXXXXXX
&
----XXX--------------
-----T---------------
---------------------
---------------------
---------------------
---------------------
---------------------
---------------------
---------------------
---------------------
---------------------
---------------------
---------------------
---------------------
XXXXXXXXXXXXXXXXXXXXX