XXXXXXXXXXXXXXXXXXXXX
XXXXXXXXXXXXXXXXXXXXX
XXXXXXXXXXXXXXXXXXXXX
XXXXXXXXXXXXXXXXXXXXX
XXXXXXXXXXXXXXXXXXXXX
--------T-------T----
---------------------
---------------------
---------------------
---------------------
---------------------
---------------------
---------------------
---------------------
XXX^XXXXXXXXX^XXXXXXX
&
XXXXXXXXXXXXXXXXXXXXX
XXXXXXXXXXXXXXXXXXXXX
XXXXXXXXXXXXXXXXXXXXX
XXXXXXXXXXXXXXXXXXXXX
XXXXXXXXXXXXXXXXXXXXX
---------T--------T--
---------------------
---------------------
---------------------
---------------------
---------------------
---------------------
---------------------
---------------------
XXXXXXXXXX^XXXXX^XXXX
&
XXXXXXXXXXXXXXXXXXXXX
XXXXXXXXXXXXXXXXXXXXX
XXXXXXXXXXXXXXXXXXXXX
XXXXXXXXXXXXXXXXXXXXX
XXXXXXXXXXXXXXXXXXXXX
-----T---------------
---------------------
---------------------
---------------------
---------------------
---------------------
---------------------
---------------------
---------------------
XXXXXXXXXXXXXXXXXXXXX
&
---------XXX-XXX-----
----------T---T------
---------------------
---------------------
---------------------
---------------------
---------------------
---------------------
---------------------
---------------------
---------------------
---------------------
---------------------
---------------------
XXXX^XXX^XXXXXXXXXXXX
&
----XXX--------------
-----T---------------
-----------XXX-------
------------T--------
---------------------
---------------------
---------------------
---------------------
---------------------
---------------------
---------------------
---------------------
---------------------
---------------------
XXXXXXXX^XXXXXXXX^XXX