----XXXXXX----
----XXXXXX----
----XXXXXX----
----XXXXXX----
----XXXXXX----
----XXXXXX----
----XXXXXX----
----XXXXXX----
----XXXXXX----
----XXXXXX----
----XXXXXX----
----V---------
--------------
--------------
XXXXXXXXXXXXXX