----XXXXXX----
----XXXXXX----
----XXXXXX----
----XXXXXX----
----XXXXXX----
----XXXXXX----
----XXXXXX----
----XXXXXX----
----XXXXXX----
----XXXXXX----
----XXXXXX----
-----V--------
--------------
--------------
XXXXXXXXXXXXXX
&
----XXXXXX----
----XXXXXX----
----XXXXXX----
----XXXXXX----
----XXXXXX----
----XXXXXX----
----XXXXXX----
----XXXXXX----
----XXXXXX----
----XXXXXX----
----XXXXXX----
--------V-----
--------------
--------------
XXXXXXXXXXXXXX
&
----XXXXXX----
----XXXXXX----
----XXXXXX----
----XXXXXX----
----XXXXXX----
----XXXXXX----
----XXXXXX----
----XXXXXX----
----XXXXXX----
----XXXXXX----
----XXXXXX----
---------V----
--------------
--------------
XXXXXXXXXXXXXX
&
----XXXXXX----
----XXXXXX----
----XXXXXX----
----XXXXXX----
----XXXXXX----
----XXXXXX----
----XXXXXX----
----XXXXXX----
----XXXXXX----
----XXXXXX----
----XXXXXX----
----V---------
--------------
--------------
XXXXXXXXXXXXXX